/mnt/scratch/clarkm89/EMR_WGS/alignments/bam_flt_orig/ELF_857.trim.bam	/mnt/scratch/clarkm89/EMR_WGS/alignments/bam_flt_reseq/ELF_857.trim.bam
/mnt/scratch/clarkm89/EMR_WGS/alignments/bam_flt_orig/GOU_13.trim.bam	/mnt/scratch/clarkm89/EMR_WGS/alignments/bam_flt_reseq/GOU_13.trim.bam
/mnt/scratch/clarkm89/EMR_WGS/alignments/bam_flt_orig/PCC_244.trim.bam	/mnt/scratch/clarkm89/EMR_WGS/alignments/bam_flt_reseq/PCC_244.trim.bam
/mnt/scratch/clarkm89/EMR_WGS/alignments/bam_flt_orig/ELF_751.trim.bam	/mnt/scratch/clarkm89/EMR_WGS/alignments/bam_flt_reseq/ELF_751.trim.bam
/mnt/scratch/clarkm89/EMR_WGS/alignments/bam_flt_orig/PCC_253.trim.bam	/mnt/scratch/clarkm89/EMR_WGS/alignments/bam_flt_reseq/PCC_253.trim.bam
/mnt/scratch/clarkm89/EMR_WGS/alignments/bam_flt_orig/HAL_6.trim.bam	/mnt/scratch/clarkm89/EMR_WGS/alignments/bam_flt_reseq/HAL_6.trim.bam
/mnt/scratch/clarkm89/EMR_WGS/alignments/bam_flt_orig/PCC_164.trim.bam	/mnt/scratch/clarkm89/EMR_WGS/alignments/bam_flt_reseq/PCC_164.trim.bam
/mnt/scratch/clarkm89/EMR_WGS/alignments/bam_flt_orig/GRA_37.trim.bam	/mnt/scratch/clarkm89/EMR_WGS/alignments/bam_flt_reseq/GRA_37.trim.bam
/mnt/scratch/clarkm89/EMR_WGS/alignments/bam_flt_orig/THR_6.trim.bam	/mnt/scratch/clarkm89/EMR_WGS/alignments/bam_flt_reseq/THR_6.trim.bam
/mnt/scratch/clarkm89/EMR_WGS/alignments/bam_flt_orig/BBI_56.trim.bam	/mnt/scratch/clarkm89/EMR_WGS/alignments/bam_flt_reseq/BBI_56.trim.bam
/mnt/scratch/clarkm89/EMR_WGS/alignments/bam_flt_orig/BBI_94.trim.bam	/mnt/scratch/clarkm89/EMR_WGS/alignments/bam_flt_reseq/BBI_94.trim.bam
/mnt/scratch/clarkm89/EMR_WGS/alignments/bam_flt_orig/ELF_192.trim.bam	/mnt/scratch/clarkm89/EMR_WGS/alignments/bam_flt_reseq/ELF_192.trim.bam
/mnt/scratch/clarkm89/EMR_WGS/alignments/bam_flt_orig/PCC_181.trim.bam	/mnt/scratch/clarkm89/EMR_WGS/alignments/bam_flt_reseq/PCC_181.trim.bam
/mnt/scratch/clarkm89/EMR_WGS/alignments/bam_flt_orig/BBI_30.trim.bam	/mnt/scratch/clarkm89/EMR_WGS/alignments/bam_flt_reseq/BBI_30.trim.bam
/mnt/scratch/clarkm89/EMR_WGS/alignments/bam_flt_orig/ONS_8.trim.bam	/mnt/scratch/clarkm89/EMR_WGS/alignments/bam_flt_reseq/ONS_8.trim.bam
/mnt/scratch/clarkm89/EMR_WGS/alignments/bam_flt_orig/GRF_5.trim.bam	/mnt/scratch/clarkm89/EMR_WGS/alignments/bam_flt_reseq/GRF_5.trim.bam
/mnt/scratch/clarkm89/EMR_WGS/alignments/bam_flt_orig/ELF_685.trim.bam	/mnt/scratch/clarkm89/EMR_WGS/alignments/bam_flt_reseq/ELF_685.trim.bam
/mnt/scratch/clarkm89/EMR_WGS/alignments/bam_flt_orig/GOU_4.trim.bam	/mnt/scratch/clarkm89/EMR_WGS/alignments/bam_flt_reseq/GOU_4.trim.bam
/mnt/scratch/clarkm89/EMR_WGS/alignments/bam_flt_orig/PCC_64.trim.bam	/mnt/scratch/clarkm89/EMR_WGS/alignments/bam_flt_reseq/PCC_64.trim.bam
/mnt/scratch/clarkm89/EMR_WGS/alignments/bam_flt_orig/THR_5.trim.bam	/mnt/scratch/clarkm89/EMR_WGS/alignments/bam_flt_reseq/THR_5.trim.bam
/mnt/scratch/clarkm89/EMR_WGS/alignments/bam_flt_orig/SEV_2.trim.bam	/mnt/scratch/clarkm89/EMR_WGS/alignments/bam_flt_reseq/SEV_2.trim.bam
/mnt/scratch/clarkm89/EMR_WGS/alignments/bam_flt_orig/MAN_16.trim.bam	/mnt/scratch/clarkm89/EMR_WGS/alignments/bam_flt_reseq/MAN_16.trim.bam
/mnt/scratch/clarkm89/EMR_WGS/alignments/bam_flt_orig/BBI_102.trim.bam	/mnt/scratch/clarkm89/EMR_WGS/alignments/bam_flt_reseq/BBI_102.trim.bam
/mnt/scratch/clarkm89/EMR_WGS/alignments/bam_flt_orig/GOU_14.trim.bam	/mnt/scratch/clarkm89/EMR_WGS/alignments/bam_flt_reseq/GOU_14.trim.bam
/mnt/scratch/clarkm89/EMR_WGS/alignments/bam_flt_orig/DEL_2.trim.bam	/mnt/scratch/clarkm89/EMR_WGS/alignments/bam_flt_reseq/DEL_2.trim.bam
/mnt/scratch/clarkm89/EMR_WGS/alignments/bam_flt_orig/GRA_41.trim.bam	/mnt/scratch/clarkm89/EMR_WGS/alignments/bam_flt_reseq/GRA_41.trim.bam
/mnt/scratch/clarkm89/EMR_WGS/alignments/bam_flt_orig/GRA_11.trim.bam	/mnt/scratch/clarkm89/EMR_WGS/alignments/bam_flt_reseq/GRA_11.trim.bam
/mnt/scratch/clarkm89/EMR_WGS/alignments/bam_flt_orig/GRA_5.trim.bam	/mnt/scratch/clarkm89/EMR_WGS/alignments/bam_flt_reseq/GRA_5.trim.bam
/mnt/scratch/clarkm89/EMR_WGS/alignments/bam_flt_orig/PCC_219.trim.bam	/mnt/scratch/clarkm89/EMR_WGS/alignments/bam_flt_reseq/PCC_219.trim.bam
/mnt/scratch/clarkm89/EMR_WGS/alignments/bam_flt_orig/GRA_13.trim.bam	/mnt/scratch/clarkm89/EMR_WGS/alignments/bam_flt_reseq/GRA_13.trim.bam
/mnt/scratch/clarkm89/EMR_WGS/alignments/bam_flt_orig/HAL_4.trim.bam	/mnt/scratch/clarkm89/EMR_WGS/alignments/bam_flt_reseq/HAL_4.trim.bam
/mnt/scratch/clarkm89/EMR_WGS/alignments/bam_flt_orig/SEV_9.trim.bam	/mnt/scratch/clarkm89/EMR_WGS/alignments/bam_flt_reseq/SEV_9.trim.bam
/mnt/scratch/clarkm89/EMR_WGS/alignments/bam_flt_orig/GRF_4.trim.bam	/mnt/scratch/clarkm89/EMR_WGS/alignments/bam_flt_reseq/GRF_4.trim.bam
/mnt/scratch/clarkm89/EMR_WGS/alignments/bam_flt_orig/GOU_16.trim.bam	/mnt/scratch/clarkm89/EMR_WGS/alignments/bam_flt_reseq/GOU_16.trim.bam
/mnt/scratch/clarkm89/EMR_WGS/alignments/bam_flt_orig/BAS_1.trim.bam	/mnt/scratch/clarkm89/EMR_WGS/alignments/bam_flt_reseq/BAS_1.trim.bam
/mnt/scratch/clarkm89/EMR_WGS/alignments/bam_flt_orig/ONS_7.trim.bam	/mnt/scratch/clarkm89/EMR_WGS/alignments/bam_flt_reseq/ONS_7.trim.bam
/mnt/scratch/clarkm89/EMR_WGS/alignments/bam_flt_orig/HUR_8.trim.bam	/mnt/scratch/clarkm89/EMR_WGS/alignments/bam_flt_reseq/HUR_8.trim.bam
/mnt/scratch/clarkm89/EMR_WGS/alignments/bam_flt_orig/MAN_14.trim.bam	/mnt/scratch/clarkm89/EMR_WGS/alignments/bam_flt_reseq/MAN_14.trim.bam
/mnt/scratch/clarkm89/EMR_WGS/alignments/bam_flt_orig/GRF_7.trim.bam	/mnt/scratch/clarkm89/EMR_WGS/alignments/bam_flt_reseq/GRF_7.trim.bam
/mnt/scratch/clarkm89/EMR_WGS/alignments/bam_flt_orig/BBI_10.trim.bam	/mnt/scratch/clarkm89/EMR_WGS/alignments/bam_flt_reseq/BBI_10.trim.bam
/mnt/scratch/clarkm89/EMR_WGS/alignments/bam_flt_orig/ELF_343.trim.bam	/mnt/scratch/clarkm89/EMR_WGS/alignments/bam_flt_reseq/ELF_343.trim.bam
/mnt/scratch/clarkm89/EMR_WGS/alignments/bam_flt_orig/MAN_5.trim.bam	/mnt/scratch/clarkm89/EMR_WGS/alignments/bam_flt_reseq/MAN_5.trim.bam
/mnt/scratch/clarkm89/EMR_WGS/alignments/bam_flt_orig/THR_4.trim.bam	/mnt/scratch/clarkm89/EMR_WGS/alignments/bam_flt_reseq/THR_4.trim.bam
/mnt/scratch/clarkm89/EMR_WGS/alignments/bam_flt_orig/ELF_463.trim.bam	/mnt/scratch/clarkm89/EMR_WGS/alignments/bam_flt_reseq/ELF_463.trim.bam
/mnt/scratch/clarkm89/EMR_WGS/alignments/bam_flt_orig/PCC_119.trim.bam	/mnt/scratch/clarkm89/EMR_WGS/alignments/bam_flt_reseq/PCC_119.trim.bam
/mnt/scratch/clarkm89/EMR_WGS/alignments/bam_flt_orig/PCC_180.trim.bam	/mnt/scratch/clarkm89/EMR_WGS/alignments/bam_flt_reseq/PCC_180.trim.bam
/mnt/scratch/clarkm89/EMR_WGS/alignments/bam_flt_orig/PCC_150.trim.bam	/mnt/scratch/clarkm89/EMR_WGS/alignments/bam_flt_reseq/PCC_150.trim.bam
/mnt/scratch/clarkm89/EMR_WGS/alignments/bam_flt_orig/HAL_5.trim.bam	/mnt/scratch/clarkm89/EMR_WGS/alignments/bam_flt_reseq/HAL_5.trim.bam
/mnt/scratch/clarkm89/EMR_WGS/alignments/bam_flt_orig/BBI_107.trim.bam	/mnt/scratch/clarkm89/EMR_WGS/alignments/bam_flt_reseq/BBI_107.trim.bam
/mnt/scratch/clarkm89/EMR_WGS/alignments/bam_flt_orig/GOU_15.trim.bam	/mnt/scratch/clarkm89/EMR_WGS/alignments/bam_flt_reseq/GOU_15.trim.bam
/mnt/scratch/clarkm89/EMR_WGS/alignments/bam_flt_orig/GRA_46.trim.bam	/mnt/scratch/clarkm89/EMR_WGS/alignments/bam_flt_reseq/GRA_46.trim.bam
/mnt/scratch/clarkm89/EMR_WGS/alignments/bam_flt_orig/GRA_43.trim.bam	/mnt/scratch/clarkm89/EMR_WGS/alignments/bam_flt_reseq/GRA_43.trim.bam
/mnt/scratch/clarkm89/EMR_WGS/alignments/bam_flt_orig/HUR_4.trim.bam	/mnt/scratch/clarkm89/EMR_WGS/alignments/bam_flt_reseq/HUR_4.trim.bam
/mnt/scratch/clarkm89/EMR_WGS/alignments/bam_flt_orig/HUR_6.trim.bam	/mnt/scratch/clarkm89/EMR_WGS/alignments/bam_flt_reseq/HUR_6.trim.bam
/mnt/scratch/clarkm89/EMR_WGS/alignments/bam_flt_orig/HUR_7.trim.bam	/mnt/scratch/clarkm89/EMR_WGS/alignments/bam_flt_reseq/HUR_7.trim.bam
/mnt/scratch/clarkm89/EMR_WGS/alignments/bam_flt_orig/ELF_816.trim.bam	/mnt/scratch/clarkm89/EMR_WGS/alignments/bam_flt_reseq/ELF_816.trim.bam
/mnt/scratch/clarkm89/EMR_WGS/alignments/bam_flt_orig/SEV_1.trim.bam	/mnt/scratch/clarkm89/EMR_WGS/alignments/bam_flt_reseq/SEV_1.trim.bam
/mnt/scratch/clarkm89/EMR_WGS/alignments/bam_flt_orig/ELF_873.trim.bam	/mnt/scratch/clarkm89/EMR_WGS/alignments/bam_flt_reseq/ELF_873.trim.bam
/mnt/scratch/clarkm89/EMR_WGS/alignments/bam_flt_orig/THR_2.trim.bam	/mnt/scratch/clarkm89/EMR_WGS/alignments/bam_flt_reseq/THR_2.trim.bam
/mnt/scratch/clarkm89/EMR_WGS/alignments/bam_flt_orig/BBI_17.trim.bam	/mnt/scratch/clarkm89/EMR_WGS/alignments/bam_flt_reseq/BBI_17.trim.bam
/mnt/scratch/clarkm89/EMR_WGS/alignments/bam_flt_orig/GRA_39.trim.bam	/mnt/scratch/clarkm89/EMR_WGS/alignments/bam_flt_reseq/GRA_39.trim.bam
/mnt/scratch/clarkm89/EMR_WGS/alignments/bam_flt_orig/BBI_6.trim.bam	/mnt/scratch/clarkm89/EMR_WGS/alignments/bam_flt_reseq/BBI_6.trim.bam
/mnt/scratch/clarkm89/EMR_WGS/alignments/bam_flt_orig/BBI_100.trim.bam	/mnt/scratch/clarkm89/EMR_WGS/alignments/bam_flt_reseq/BBI_100.trim.bam
/mnt/scratch/clarkm89/EMR_WGS/alignments/bam_flt_orig/GRA_35.trim.bam	/mnt/scratch/clarkm89/EMR_WGS/alignments/bam_flt_reseq/GRA_35.trim.bam
/mnt/scratch/clarkm89/EMR_WGS/alignments/bam_flt_orig/BBI_46.trim.bam	/mnt/scratch/clarkm89/EMR_WGS/alignments/bam_flt_reseq/BBI_46.trim.bam
/mnt/scratch/clarkm89/EMR_WGS/alignments/bam_flt_orig/BBI_1.trim.bam	/mnt/scratch/clarkm89/EMR_WGS/alignments/bam_flt_reseq/BBI_1.trim.bam
/mnt/scratch/clarkm89/EMR_WGS/alignments/bam_flt_orig/BBI_98.trim.bam	/mnt/scratch/clarkm89/EMR_WGS/alignments/bam_flt_reseq/BBI_98.trim.bam
/mnt/scratch/clarkm89/EMR_WGS/alignments/bam_flt_orig/ELF_240.trim.bam	/mnt/scratch/clarkm89/EMR_WGS/alignments/bam_flt_reseq/ELF_240.trim.bam
/mnt/scratch/clarkm89/EMR_WGS/alignments/bam_flt_orig/HAL_12.trim.bam	/mnt/scratch/clarkm89/EMR_WGS/alignments/bam_flt_reseq/HAL_12.trim.bam
/mnt/scratch/clarkm89/EMR_WGS/alignments/bam_flt_orig/GOU_11.trim.bam	/mnt/scratch/clarkm89/EMR_WGS/alignments/bam_flt_reseq/GOU_11.trim.bam
/mnt/scratch/clarkm89/EMR_WGS/alignments/bam_flt_orig/SEV_8.trim.bam	/mnt/scratch/clarkm89/EMR_WGS/alignments/bam_flt_reseq/SEV_8.trim.bam
/mnt/scratch/clarkm89/EMR_WGS/alignments/bam_flt_orig/HUR_1.trim.bam	/mnt/scratch/clarkm89/EMR_WGS/alignments/bam_flt_reseq/HUR_1.trim.bam
/mnt/scratch/clarkm89/EMR_WGS/alignments/bam_flt_orig/GOU_3.trim.bam	/mnt/scratch/clarkm89/EMR_WGS/alignments/bam_flt_reseq/GOU_3.trim.bam
/mnt/scratch/clarkm89/EMR_WGS/alignments/bam_flt_orig/GOU_6.trim.bam	/mnt/scratch/clarkm89/EMR_WGS/alignments/bam_flt_reseq/GOU_6.trim.bam
/mnt/scratch/clarkm89/EMR_WGS/alignments/bam_flt_orig/GOU_10.trim.bam	/mnt/scratch/clarkm89/EMR_WGS/alignments/bam_flt_reseq/GOU_10.trim.bam
/mnt/scratch/clarkm89/EMR_WGS/alignments/bam_flt_orig/GRA_36.trim.bam	/mnt/scratch/clarkm89/EMR_WGS/alignments/bam_flt_reseq/GRA_36.trim.bam
/mnt/scratch/clarkm89/EMR_WGS/alignments/bam_flt_orig/SEV_5.trim.bam	/mnt/scratch/clarkm89/EMR_WGS/alignments/bam_flt_reseq/SEV_5.trim.bam
/mnt/scratch/clarkm89/EMR_WGS/alignments/bam_flt_orig/OTI_6.trim.bam	/mnt/scratch/clarkm89/EMR_WGS/alignments/bam_flt_reseq/OTI_6.trim.bam
/mnt/scratch/clarkm89/EMR_WGS/alignments/bam_flt_orig/GOU_8.trim.bam	/mnt/scratch/clarkm89/EMR_WGS/alignments/bam_flt_reseq/GOU_8.trim.bam
/mnt/scratch/clarkm89/EMR_WGS/alignments/bam_flt_orig/GRA_38.trim.bam	/mnt/scratch/clarkm89/EMR_WGS/alignments/bam_flt_reseq/GRA_38.trim.bam
/mnt/scratch/clarkm89/EMR_WGS/alignments/bam_flt_orig/PCC_275.trim.bam	/mnt/scratch/clarkm89/EMR_WGS/alignments/bam_flt_reseq/PCC_275.trim.bam
/mnt/scratch/clarkm89/EMR_WGS/alignments/bam_flt_orig/ELF_107.trim.bam	/mnt/scratch/clarkm89/EMR_WGS/alignments/bam_flt_reseq/ELF_107.trim.bam
/mnt/scratch/clarkm89/EMR_WGS/alignments/bam_flt_orig/ELF_673.trim.bam	/mnt/scratch/clarkm89/EMR_WGS/alignments/bam_flt_reseq/ELF_673.trim.bam
/mnt/scratch/clarkm89/EMR_WGS/alignments/bam_flt_orig/ELF_277.trim.bam	/mnt/scratch/clarkm89/EMR_WGS/alignments/bam_flt_reseq/ELF_277.trim.bam
/mnt/scratch/clarkm89/EMR_WGS/alignments/bam_flt_orig/GRA_31.trim.bam	/mnt/scratch/clarkm89/EMR_WGS/alignments/bam_flt_reseq/GRA_31.trim.bam
/mnt/scratch/clarkm89/EMR_WGS/alignments/bam_flt_orig/HAL_8.trim.bam	/mnt/scratch/clarkm89/EMR_WGS/alignments/bam_flt_reseq/HAL_8.trim.bam
/mnt/scratch/clarkm89/EMR_WGS/alignments/bam_flt_orig/HAL_3.trim.bam	/mnt/scratch/clarkm89/EMR_WGS/alignments/bam_flt_reseq/HAL_3.trim.bam
/mnt/scratch/clarkm89/EMR_WGS/alignments/bam_flt_orig/GRF_6.trim.bam	/mnt/scratch/clarkm89/EMR_WGS/alignments/bam_flt_reseq/GRF_6.trim.bam
/mnt/scratch/clarkm89/EMR_WGS/alignments/bam_flt_orig/ELF_916.trim.bam	/mnt/scratch/clarkm89/EMR_WGS/alignments/bam_flt_reseq/ELF_916.trim.bam
/mnt/scratch/clarkm89/EMR_WGS/alignments/bam_flt_orig/BBI_23.trim.bam	/mnt/scratch/clarkm89/EMR_WGS/alignments/bam_flt_reseq/BBI_23.trim.bam
/mnt/scratch/clarkm89/EMR_WGS/alignments/bam_flt_orig/GOU_17.trim.bam	/mnt/scratch/clarkm89/EMR_WGS/alignments/bam_flt_reseq/GOU_17.trim.bam
/mnt/scratch/clarkm89/EMR_WGS/alignments/bam_flt_orig/GRA_49.trim.bam	/mnt/scratch/clarkm89/EMR_WGS/alignments/bam_flt_reseq/GRA_49.trim.bam
/mnt/scratch/clarkm89/EMR_WGS/alignments/bam_flt_orig/BBI_50.trim.bam	/mnt/scratch/clarkm89/EMR_WGS/alignments/bam_flt_reseq/BBI_50.trim.bam
/mnt/scratch/clarkm89/EMR_WGS/alignments/bam_flt_orig/OTI_3.trim.bam	/mnt/scratch/clarkm89/EMR_WGS/alignments/bam_flt_reseq/OTI_3.trim.bam
/mnt/scratch/clarkm89/EMR_WGS/alignments/bam_flt_orig/BBI_9.trim.bam	/mnt/scratch/clarkm89/EMR_WGS/alignments/bam_flt_reseq/BBI_9.trim.bam
/mnt/scratch/clarkm89/EMR_WGS/alignments/bam_flt_orig/HUR_5.trim.bam	/mnt/scratch/clarkm89/EMR_WGS/alignments/bam_flt_reseq/HUR_5.trim.bam
/mnt/scratch/clarkm89/EMR_WGS/alignments/bam_flt_orig/ELF_709.trim.bam	/mnt/scratch/clarkm89/EMR_WGS/alignments/bam_flt_reseq/ELF_709.trim.bam
/mnt/scratch/clarkm89/EMR_WGS/alignments/bam_flt_orig/MAN_2.trim.bam	/mnt/scratch/clarkm89/EMR_WGS/alignments/bam_flt_reseq/MAN_2.trim.bam
/mnt/scratch/clarkm89/EMR_WGS/alignments/bam_flt_orig/SEV_12.trim.bam	/mnt/scratch/clarkm89/EMR_WGS/alignments/bam_flt_reseq/SEV_12.trim.bam
/mnt/scratch/clarkm89/EMR_WGS/alignments/bam_flt_orig/THR_1.trim.bam	/mnt/scratch/clarkm89/EMR_WGS/alignments/bam_flt_reseq/THR_1.trim.bam
/mnt/scratch/clarkm89/EMR_WGS/alignments/bam_flt_orig/MAN_11.trim.bam	/mnt/scratch/clarkm89/EMR_WGS/alignments/bam_flt_reseq/MAN_11.trim.bam
/mnt/scratch/clarkm89/EMR_WGS/alignments/bam_flt_orig/MAN_13.trim.bam	/mnt/scratch/clarkm89/EMR_WGS/alignments/bam_flt_reseq/MAN_13.trim.bam
/mnt/scratch/clarkm89/EMR_WGS/alignments/bam_flt_orig/DEL_1.trim.bam	/mnt/scratch/clarkm89/EMR_WGS/alignments/bam_flt_reseq/DEL_1.trim.bam
/mnt/scratch/clarkm89/EMR_WGS/alignments/bam_flt_orig/GRA_26.trim.bam	/mnt/scratch/clarkm89/EMR_WGS/alignments/bam_flt_reseq/GRA_26.trim.bam
/mnt/scratch/clarkm89/EMR_WGS/alignments/bam_flt_orig/THR_7.trim.bam	/mnt/scratch/clarkm89/EMR_WGS/alignments/bam_flt_reseq/THR_7.trim.bam
/mnt/scratch/clarkm89/EMR_WGS/alignments/bam_flt_orig/GRA_22.trim.bam	/mnt/scratch/clarkm89/EMR_WGS/alignments/bam_flt_reseq/GRA_22.trim.bam
/mnt/scratch/clarkm89/EMR_WGS/alignments/bam_flt_orig/BBI_49.trim.bam	/mnt/scratch/clarkm89/EMR_WGS/alignments/bam_flt_reseq/BBI_49.trim.bam
/mnt/scratch/clarkm89/EMR_WGS/alignments/bam_flt_orig/SEV_6.trim.bam	/mnt/scratch/clarkm89/EMR_WGS/alignments/bam_flt_reseq/SEV_6.trim.bam
/mnt/scratch/clarkm89/EMR_WGS/alignments/bam_flt_orig/GRA_1.trim.bam	/mnt/scratch/clarkm89/EMR_WGS/alignments/bam_flt_reseq/GRA_1.trim.bam
/mnt/scratch/clarkm89/EMR_WGS/alignments/bam_flt_orig/PCC_56.trim.bam	/mnt/scratch/clarkm89/EMR_WGS/alignments/bam_flt_reseq/PCC_56.trim.bam
/mnt/scratch/clarkm89/EMR_WGS/alignments/bam_flt_orig/GOU_2.trim.bam	/mnt/scratch/clarkm89/EMR_WGS/alignments/bam_flt_reseq/GOU_2.trim.bam
/mnt/scratch/clarkm89/EMR_WGS/alignments/bam_flt_orig/MAN_12.trim.bam	/mnt/scratch/clarkm89/EMR_WGS/alignments/bam_flt_reseq/MAN_12.trim.bam
/mnt/scratch/clarkm89/EMR_WGS/alignments/bam_flt_orig/THR_10.trim.bam	/mnt/scratch/clarkm89/EMR_WGS/alignments/bam_flt_reseq/THR_10.trim.bam
/mnt/scratch/clarkm89/EMR_WGS/alignments/bam_flt_orig/THR_11.trim.bam	/mnt/scratch/clarkm89/EMR_WGS/alignments/bam_flt_reseq/THR_11.trim.bam
/mnt/scratch/clarkm89/EMR_WGS/alignments/bam_flt_orig/THR_8.trim.bam	/mnt/scratch/clarkm89/EMR_WGS/alignments/bam_flt_reseq/THR_8.trim.bam
/mnt/scratch/clarkm89/EMR_WGS/alignments/bam_flt_orig/PCC_79.trim.bam	/mnt/scratch/clarkm89/EMR_WGS/alignments/bam_flt_reseq/PCC_79.trim.bam
/mnt/scratch/clarkm89/EMR_WGS/alignments/bam_flt_orig/HAL_14.trim.bam	/mnt/scratch/clarkm89/EMR_WGS/alignments/bam_flt_reseq/HAL_14.trim.bam
/mnt/scratch/clarkm89/EMR_WGS/alignments/bam_flt_orig/ELF_901.trim.bam	/mnt/scratch/clarkm89/EMR_WGS/alignments/bam_flt_reseq/ELF_901.trim.bam
/mnt/scratch/clarkm89/EMR_WGS/alignments/bam_flt_orig/GRF_9.trim.bam	/mnt/scratch/clarkm89/EMR_WGS/alignments/bam_flt_reseq/GRF_9.trim.bam
/mnt/scratch/clarkm89/EMR_WGS/alignments/bam_flt_orig/GRF_1.trim.bam	/mnt/scratch/clarkm89/EMR_WGS/alignments/bam_flt_reseq/GRF_1.trim.bam
/mnt/scratch/clarkm89/EMR_WGS/alignments/bam_flt_orig/GRA_2.trim.bam	/mnt/scratch/clarkm89/EMR_WGS/alignments/bam_flt_reseq/GRA_2.trim.bam
/mnt/scratch/clarkm89/EMR_WGS/alignments/bam_flt_orig/GOU_12.trim.bam	/mnt/scratch/clarkm89/EMR_WGS/alignments/bam_flt_reseq/GOU_12.trim.bam
/mnt/scratch/clarkm89/EMR_WGS/alignments/bam_flt_orig/ELF_823.trim.bam	/mnt/scratch/clarkm89/EMR_WGS/alignments/bam_flt_reseq/ELF_823.trim.bam
/mnt/scratch/clarkm89/EMR_WGS/alignments/bam_flt_orig/ATL_1.trim.bam	/mnt/scratch/clarkm89/EMR_WGS/alignments/bam_flt_reseq/ATL_1.trim.bam
/mnt/scratch/clarkm89/EMR_WGS/alignments/bam_flt_orig/HAL_1.trim.bam	/mnt/scratch/clarkm89/EMR_WGS/alignments/bam_flt_reseq/HAL_1.trim.bam
/mnt/scratch/clarkm89/EMR_WGS/alignments/bam_flt_orig/MAN_15.trim.bam	/mnt/scratch/clarkm89/EMR_WGS/alignments/bam_flt_reseq/MAN_15.trim.bam
/mnt/scratch/clarkm89/EMR_WGS/alignments/bam_flt_orig/PCC_172.trim.bam	/mnt/scratch/clarkm89/EMR_WGS/alignments/bam_flt_reseq/PCC_172.trim.bam
/mnt/scratch/clarkm89/EMR_WGS/alignments/bam_flt_orig/ONS_6.trim.bam	/mnt/scratch/clarkm89/EMR_WGS/alignments/bam_flt_reseq/ONS_6.trim.bam
/mnt/scratch/clarkm89/EMR_WGS/alignments/bam_flt_orig/ELF_927.trim.bam	/mnt/scratch/clarkm89/EMR_WGS/alignments/bam_flt_reseq/ELF_927.trim.bam
/mnt/scratch/clarkm89/EMR_WGS/alignments/bam_flt_orig/MAN_1.trim.bam	/mnt/scratch/clarkm89/EMR_WGS/alignments/bam_flt_reseq/MAN_1.trim.bam
/mnt/scratch/clarkm89/EMR_WGS/alignments/bam_flt_orig/SEV_10.trim.bam	/mnt/scratch/clarkm89/EMR_WGS/alignments/bam_flt_reseq/SEV_10.trim.bam
/mnt/scratch/clarkm89/EMR_WGS/alignments/bam_flt_orig/PCC_136.trim.bam	/mnt/scratch/clarkm89/EMR_WGS/alignments/bam_flt_reseq/PCC_136.trim.bam
/mnt/scratch/clarkm89/EMR_WGS/alignments/bam_flt_orig/BBI_90.trim.bam	/mnt/scratch/clarkm89/EMR_WGS/alignments/bam_flt_reseq/BBI_90.trim.bam
/mnt/scratch/clarkm89/EMR_WGS/alignments/bam_flt_orig/MAN_7.trim.bam	/mnt/scratch/clarkm89/EMR_WGS/alignments/bam_flt_reseq/MAN_7.trim.bam
/mnt/scratch/clarkm89/EMR_WGS/alignments/bam_flt_orig/MAN_4.trim.bam	/mnt/scratch/clarkm89/EMR_WGS/alignments/bam_flt_reseq/MAN_4.trim.bam
/mnt/scratch/clarkm89/EMR_WGS/alignments/bam_flt_orig/GRA_33.trim.bam	/mnt/scratch/clarkm89/EMR_WGS/alignments/bam_flt_reseq/GRA_33.trim.bam
/mnt/scratch/clarkm89/EMR_WGS/alignments/bam_flt_orig/GOU_7.trim.bam	/mnt/scratch/clarkm89/EMR_WGS/alignments/bam_flt_reseq/GOU_7.trim.bam
/mnt/scratch/clarkm89/EMR_WGS/alignments/bam_flt_orig/GRF_3.trim.bam	/mnt/scratch/clarkm89/EMR_WGS/alignments/bam_flt_reseq/GRF_3.trim.bam
/mnt/scratch/clarkm89/EMR_WGS/alignments/bam_flt_orig/GRA_30.trim.bam	/mnt/scratch/clarkm89/EMR_WGS/alignments/bam_flt_reseq/GRA_30.trim.bam
/mnt/scratch/clarkm89/EMR_WGS/alignments/bam_flt_orig/GRA_42.trim.bam	/mnt/scratch/clarkm89/EMR_WGS/alignments/bam_flt_reseq/GRA_42.trim.bam
/mnt/scratch/clarkm89/EMR_WGS/alignments/bam_flt_orig/HAL_9.trim.bam	/mnt/scratch/clarkm89/EMR_WGS/alignments/bam_flt_reseq/HAL_9.trim.bam
/mnt/scratch/clarkm89/EMR_WGS/alignments/bam_flt_orig/BBI_39.trim.bam	/mnt/scratch/clarkm89/EMR_WGS/alignments/bam_flt_reseq/BBI_39.trim.bam
/mnt/scratch/clarkm89/EMR_WGS/alignments/bam_flt_orig/GRF_8.trim.bam	/mnt/scratch/clarkm89/EMR_WGS/alignments/bam_flt_reseq/GRF_8.trim.bam
/mnt/scratch/clarkm89/EMR_WGS/alignments/bam_flt_orig/SEV_11.trim.bam	/mnt/scratch/clarkm89/EMR_WGS/alignments/bam_flt_reseq/SEV_11.trim.bam
/mnt/scratch/clarkm89/EMR_WGS/alignments/bam_flt_orig/PCC_135.trim.bam	/mnt/scratch/clarkm89/EMR_WGS/alignments/bam_flt_reseq/PCC_135.trim.bam
/mnt/scratch/clarkm89/EMR_WGS/alignments/bam_flt_orig/GOU_1.trim.bam	/mnt/scratch/clarkm89/EMR_WGS/alignments/bam_flt_reseq/GOU_1.trim.bam
/mnt/scratch/clarkm89/EMR_WGS/alignments/bam_flt_orig/HAL_2.trim.bam	/mnt/scratch/clarkm89/EMR_WGS/alignments/bam_flt_reseq/HAL_2.trim.bam
/mnt/scratch/clarkm89/EMR_WGS/alignments/bam_flt_orig/PCC_194.trim.bam	/mnt/scratch/clarkm89/EMR_WGS/alignments/bam_flt_reseq/PCC_194.trim.bam
/mnt/scratch/clarkm89/EMR_WGS/alignments/bam_flt_orig/OTI_2.trim.bam	/mnt/scratch/clarkm89/EMR_WGS/alignments/bam_flt_reseq/OTI_2.trim.bam
/mnt/scratch/clarkm89/EMR_WGS/alignments/bam_flt_orig/BBI_61.trim.bam	/mnt/scratch/clarkm89/EMR_WGS/alignments/bam_flt_reseq/BBI_61.trim.bam
/mnt/scratch/clarkm89/EMR_WGS/alignments/bam_flt_orig/ONS_4.trim.bam	/mnt/scratch/clarkm89/EMR_WGS/alignments/bam_flt_reseq/ONS_4.trim.bam
/mnt/scratch/clarkm89/EMR_WGS/alignments/bam_flt_orig/MAN_6.trim.bam	/mnt/scratch/clarkm89/EMR_WGS/alignments/bam_flt_reseq/MAN_6.trim.bam
/mnt/scratch/clarkm89/EMR_WGS/alignments/bam_flt_orig/BBI_40.trim.bam	/mnt/scratch/clarkm89/EMR_WGS/alignments/bam_flt_reseq/BBI_40.trim.bam
/mnt/scratch/clarkm89/EMR_WGS/alignments/bam_flt_orig/GRA_17.trim.bam	/mnt/scratch/clarkm89/EMR_WGS/alignments/bam_flt_reseq/GRA_17.trim.bam
/mnt/scratch/clarkm89/EMR_WGS/alignments/bam_flt_orig/SEV_4.trim.bam	/mnt/scratch/clarkm89/EMR_WGS/alignments/bam_flt_reseq/SEV_4.trim.bam
/mnt/scratch/clarkm89/EMR_WGS/alignments/bam_flt_orig/ELF_507.trim.bam	/mnt/scratch/clarkm89/EMR_WGS/alignments/bam_flt_reseq/ELF_507.trim.bam
/mnt/scratch/clarkm89/EMR_WGS/alignments/bam_flt_orig/ELF_869.trim.bam	/mnt/scratch/clarkm89/EMR_WGS/alignments/bam_flt_reseq/ELF_869.trim.bam
/mnt/scratch/clarkm89/EMR_WGS/alignments/bam_flt_orig/GRF_2.trim.bam	/mnt/scratch/clarkm89/EMR_WGS/alignments/bam_flt_reseq/GRF_2.trim.bam
/mnt/scratch/clarkm89/EMR_WGS/alignments/bam_flt_orig/SEV_7.trim.bam	/mnt/scratch/clarkm89/EMR_WGS/alignments/bam_flt_reseq/SEV_7.trim.bam
/mnt/scratch/clarkm89/EMR_WGS/alignments/bam_flt_orig/GRA_19.trim.bam	/mnt/scratch/clarkm89/EMR_WGS/alignments/bam_flt_reseq/GRA_19.trim.bam
/mnt/scratch/clarkm89/EMR_WGS/alignments/bam_flt_orig/GOU_9.trim.bam	/mnt/scratch/clarkm89/EMR_WGS/alignments/bam_flt_reseq/GOU_9.trim.bam
/mnt/scratch/clarkm89/EMR_WGS/alignments/bam_flt_orig/MAN_10.trim.bam	/mnt/scratch/clarkm89/EMR_WGS/alignments/bam_flt_reseq/MAN_10.trim.bam
/mnt/scratch/clarkm89/EMR_WGS/alignments/bam_flt_orig/SEV_3.trim.bam	/mnt/scratch/clarkm89/EMR_WGS/alignments/bam_flt_reseq/SEV_3.trim.bam
/mnt/scratch/clarkm89/EMR_WGS/alignments/bam_flt_orig/HUR_3.trim.bam	/mnt/scratch/clarkm89/EMR_WGS/alignments/bam_flt_reseq/HUR_3.trim.bam
/mnt/scratch/clarkm89/EMR_WGS/alignments/bam_flt_orig/GOU_5.trim.bam	/mnt/scratch/clarkm89/EMR_WGS/alignments/bam_flt_reseq/GOU_5.trim.bam
/mnt/scratch/clarkm89/EMR_WGS/alignments/bam_flt_orig/PCC_26.trim.bam	/mnt/scratch/clarkm89/EMR_WGS/alignments/bam_flt_reseq/PCC_26.trim.bam
/mnt/scratch/clarkm89/EMR_WGS/alignments/bam_flt_orig/HUR_2.trim.bam	/mnt/scratch/clarkm89/EMR_WGS/alignments/bam_flt_reseq/HUR_2.trim.bam
/mnt/scratch/clarkm89/EMR_WGS/alignments/bam_flt_orig/PCC_168.trim.bam	/mnt/scratch/clarkm89/EMR_WGS/alignments/bam_flt_reseq/PCC_168.trim.bam
/mnt/scratch/clarkm89/EMR_WGS/alignments/bam_flt_orig/GRA_14.trim.bam	/mnt/scratch/clarkm89/EMR_WGS/alignments/bam_flt_reseq/GRA_14.trim.bam
/mnt/scratch/clarkm89/EMR_WGS/alignments/bam_flt_orig/GRA_6.trim.bam	/mnt/scratch/clarkm89/EMR_WGS/alignments/bam_flt_reseq/GRA_6.trim.bam
/mnt/scratch/clarkm89/EMR_WGS/alignments/bam_flt_orig/PCC_211.trim.bam	/mnt/scratch/clarkm89/EMR_WGS/alignments/bam_flt_reseq/PCC_211.trim.bam
/mnt/scratch/clarkm89/EMR_WGS/alignments/bam_flt_orig/HAL_13.trim.bam	/mnt/scratch/clarkm89/EMR_WGS/alignments/bam_flt_reseq/HAL_13.trim.bam
/mnt/scratch/clarkm89/EMR_WGS/alignments/bam_flt_orig/HAL_11.trim.bam	/mnt/scratch/clarkm89/EMR_WGS/alignments/bam_flt_reseq/HAL_11.trim.bam
/mnt/scratch/clarkm89/EMR_WGS/alignments/bam_flt_orig/ONS_1.trim.bam	/mnt/scratch/clarkm89/EMR_WGS/alignments/bam_flt_reseq/ONS_1.trim.bam
/mnt/scratch/clarkm89/EMR_WGS/alignments/bam_flt_orig/ELF_202.trim.bam	/mnt/scratch/clarkm89/EMR_WGS/alignments/bam_flt_reseq/ELF_202.trim.bam
/mnt/scratch/clarkm89/EMR_WGS/alignments/bam_flt_orig/OTI_4.trim.bam	/mnt/scratch/clarkm89/EMR_WGS/alignments/bam_flt_reseq/OTI_4.trim.bam
/mnt/scratch/clarkm89/EMR_WGS/alignments/bam_flt_orig/OTI_1.trim.bam	/mnt/scratch/clarkm89/EMR_WGS/alignments/bam_flt_reseq/OTI_1.trim.bam
/mnt/scratch/clarkm89/EMR_WGS/alignments/bam_flt_orig/ATL_2.trim.bam	/mnt/scratch/clarkm89/EMR_WGS/alignments/bam_flt_reseq/ATL_2.trim.bam
/mnt/scratch/clarkm89/EMR_WGS/alignments/bam_flt_orig/BBI_20.trim.bam	/mnt/scratch/clarkm89/EMR_WGS/alignments/bam_flt_reseq/BBI_20.trim.bam
/mnt/scratch/clarkm89/EMR_WGS/alignments/bam_flt_orig/OTI_5.trim.bam	/mnt/scratch/clarkm89/EMR_WGS/alignments/bam_flt_reseq/OTI_5.trim.bam
/mnt/scratch/clarkm89/EMR_WGS/alignments/bam_flt_orig/MAN_9.trim.bam	/mnt/scratch/clarkm89/EMR_WGS/alignments/bam_flt_reseq/MAN_9.trim.bam
/mnt/scratch/clarkm89/EMR_WGS/alignments/bam_flt_orig/THR_9.trim.bam	/mnt/scratch/clarkm89/EMR_WGS/alignments/bam_flt_reseq/THR_9.trim.bam
/mnt/scratch/clarkm89/EMR_WGS/alignments/bam_flt_orig/BBI_79.trim.bam	/mnt/scratch/clarkm89/EMR_WGS/alignments/bam_flt_reseq/BBI_79.trim.bam
/mnt/scratch/clarkm89/EMR_WGS/alignments/bam_flt_orig/MAN_3.trim.bam	/mnt/scratch/clarkm89/EMR_WGS/alignments/bam_flt_reseq/MAN_3.trim.bam
/mnt/scratch/clarkm89/EMR_WGS/alignments/bam_flt_orig/MAN_8.trim.bam	/mnt/scratch/clarkm89/EMR_WGS/alignments/bam_flt_reseq/MAN_8.trim.bam
/mnt/scratch/clarkm89/EMR_WGS/alignments/bam_flt_orig/HAL_7.trim.bam	/mnt/scratch/clarkm89/EMR_WGS/alignments/bam_flt_reseq/HAL_7.trim.bam
/mnt/scratch/clarkm89/EMR_WGS/alignments/bam_flt_orig/ONS_3.trim.bam	/mnt/scratch/clarkm89/EMR_WGS/alignments/bam_flt_reseq/ONS_3.trim.bam
/mnt/scratch/clarkm89/EMR_WGS/alignments/bam_flt_orig/ONS_5.trim.bam	/mnt/scratch/clarkm89/EMR_WGS/alignments/bam_flt_reseq/ONS_5.trim.bam
/mnt/scratch/clarkm89/EMR_WGS/alignments/bam_flt_orig/PCC_115.trim.bam	/mnt/scratch/clarkm89/EMR_WGS/alignments/bam_flt_reseq/PCC_115.trim.bam
/mnt/scratch/clarkm89/EMR_WGS/alignments/bam_flt_orig/BBI_32.trim.bam	/mnt/scratch/clarkm89/EMR_WGS/alignments/bam_flt_reseq/BBI_32.trim.bam
/mnt/scratch/clarkm89/EMR_WGS/alignments/bam_flt_orig/ONS_2.trim.bam	/mnt/scratch/clarkm89/EMR_WGS/alignments/bam_flt_reseq/ONS_2.trim.bam
/mnt/scratch/clarkm89/EMR_WGS/alignments/bam_flt_orig/BBI_24.trim.bam	/mnt/scratch/clarkm89/EMR_WGS/alignments/bam_flt_reseq/BBI_24.trim.bam
/mnt/scratch/clarkm89/EMR_WGS/alignments/bam_flt_orig/ELF_335L2.trim.bam   /mnt/scratch/clarkm89/EMR_WGS/alignments/bam_flt_orig/ELF_335L3.trim.bam
